7 7
#######
#A....#
####..#
#..#..#
####..#
#.....#
#######