12 14
##############
#..A.........#
#.####.#####.#
#.#....#...#.#
#.#.####.###.#
#.#.#..#.#...#
#......#.#.###
#.####.#.#.#.#
#.#....#.#.###
###.######.#.#
#.#........#.#
##############